000000000000
011113111000
010010001000
011111111000
010001110000
011111100000
010100110000
010100011000
011111112000
000000000000
000000000000
000000000000